10 10 80
##########
# *      #
#    ### #
# *#    *#
# ###    #
#I  > *  #
#**## *  #
# ## *  C#
#*     * #
##########
