30 60 1637
############################################################
#  *    *  *         **    *           **    *  **  * *   *#
#**        *    #*     ** #         * *   C        # * * * #
#  # ##  #      # *     # #     ##   ###* * *##*## #   ###*#
# ##  ## # **  *###   *## # ###*##   #   ## *## ## ###  # *#
#* #     ### ##*   * #  #      **  # #   *## *  * *   *    #
# *  ##  *    ##*   ## *  ##*  #*  #         ### ### * ###*#
# #  ## ###  *      #** #**##*###  #*### ##  #    #    ### #
# # **   * * ##  * *   ##        *   ###  ## #*        ### #
# # #*  #  #  ## * ### #* # >  *## #*###    *  * * *#  ###*#
#   #   # ##     #       *## #  ## # ### ######  *  ## ### #
# ##### #* #    ### ##### *# ##    # ### ###### ### #  ### #
#*           ##    *  #       # ##  *### ######  * *       #
#*#   ###### ##**#    #    # *   ##             ###  # ###*#
# #  *######     #**      ###          ##     *      #* *  #
# ### ###### ###*# ##  ##*       *### ##**### ###### ### **#
# # *      **   *  ## ## *###  ## ***    *  # ###### # *   #
# #   #     ######   *        ##* #####    *# ###### #   # #
#    P## ##*######  # #  #      *** #     *      *       # #
# * #  #*## ######*## ## ## ###  *  #*   *   #     *   # # #
#   #      *   *   #  #*  #     *       * *  #     *I  #   #
# ### #####  #   *   *      #  # *    ######*###     ##### #
#   #   #*  ## ##* ##*  ### ## ## ### ###### #   ###*  *  *#
#*  # **#  *# * ##  ##  ### #   #  #  ###### # * #  *  #   #
#      *         *     *### *     *   B  *       #     #  *#
#  #*#  *#  # ######   *### #  *#    ##### #   #     ###   #
# ## ## ## ## ###### ## ### #** # ##   #   ## ##  ## * # **#
# #   # #* #**###### ## ### # ### ##  *#  * # #  ##  * #   #
#*      *     *     ***                                    #
############################################################
