5 7 6
#######
#  P *#
#     #
#>    #
#######
