15 30 390
##############################
#*         *        C   *    #
# #    #         #*          #
# # * ## #   ### ## ##  ##** #
# ### #  #   #   #   ##  ##  #
#*  B    ###*# *             #
# #####     *    #   ######  #
#*  #   ##  # ## #   ######  #
#  *#*  ## ## ## ###P######  #
#     *   *#             *   #
#   * ###*   I# >#  #* # #   #
#**##** #  #* # ## ## ## #   #
# ##    # ### #**# # *#  #   #
#    *    * *       *       *#
##############################
