20 20 351
####################
#     *     ***   *#
#         ### *#   #
#      ## #* I##   #
#*    ##  #  *#    #
# ###        *     #
#   *  * ### ###   #
#  ##    ### ###   #
# ##  *  ###>###   #
#    *   ### ###   #
#   # *  ### ### **#
#   #    ### ###   #
# ### ##   * **B   #
#   #  ##*    *##  #
#   #   *       ## #
#    P   #####*    #
#*##  ##   # *  ## #
# ## ##    #   ##* #
#           *      #
####################
