6 7 20
#######
#*   *#
#  * B#
#  ##*#
#>    #
#######
